1111111111111
100100P000001
10000111110C1
1C0011E000001
1111111111111
