1111111111111
100100Y0000C1
10Y0011111001
10P011E000001
1111111111111